--------------------
--------------------
----l-----l-------l-
--------------------
---------9----------
--l----8------------
--------------l-----
-------7------------
-----------l--------
--l----6------------
---------------l----
------5-------------
--------4-3-2-------
--l-----------1-----
----------------0---
----------l---------
--------------------
--l-----------------
--------------------
--------------------
